40 21
80 144
1 1 1 1 1 1 1 1 1 1 1 1 1 1 1 1 1 1 1 1 1 1 1 1 1 1 1 8 8 8 8 8 8 8 8 8 8 8 8 8
1 7 7 7 7 7 7 7 7 7 7 7 1 7 1 7 1 7 7 7 1 7 7 7 1 7 1 8 8 8 8 8 8 8 8 8 8 8 8 8
1 7 7 7 7 7 1 7 1 7 1 1 1 7 1 7 1 7 1 7 1 7 1 1 1 7 1 8 8 8 8 8 8 8 8 8 8 8 8 8
1 7 7 7 7 7 1 7 1 7 1 7 7 7 7 7 1 7 1 7 7 7 1 7 7 7 1 8 8 8 8 8 8 8 8 8 8 8 8 8
1 7 7 7 7 7 1 7 1 1 1 1 1 7 1 1 1 1 1 1 1 7 1 7 1 7 1 8 8 8 8 8 8 8 8 8 8 8 8 8
1 7 7 7 7 7 1 7 1 7 1 7 7 7 7 7 7 7 7 7 7 7 7 7 1 7 1 8 8 8 8 8 8 8 8 8 8 8 8 8
1 1 1 1 1 1 1 7 1 7 1 1 1 1 1 1 1 1 1 7 1 7 1 1 1 1 1 8 8 8 8 8 8 8 8 8 8 8 8 8
8 8 8 8 8 8 1 7 7 7 1 7 7 7 7 7 1 7 1 7 1 7 7 7 7 7 1 8 8 8 8 8 8 8 8 8 8 8 8 8
8 8 8 8 8 8 1 1 1 7 1 1 1 7 1 1 1 7 1 7 1 1 1 7 1 1 1 8 8 8 8 8 8 8 8 8 8 8 8 8
8 8 8 8 8 8 1 7 1 7 1 7 7 7 7 7 7 7 7 7 7 7 1 7 1 7 1 8 8 1 1 1 1 1 1 1 1 1 1 8
8 8 8 8 8 8 1 7 1 7 1 1 1 7 1 7 1 7 1 7 1 1 1 7 1 7 1 8 8 1 7 7 7 7 7 7 7 7 1 8
8 8 8 8 8 8 1 7 1 7 7 7 1 7 1 7 1 7 1 7 7 7 1 7 1 7 1 8 8 1 7 7 7 7 7 7 7 7 1 8
8 8 8 8 8 8 1 7 1 1 1 7 1 1 1 7 1 7 1 7 1 1 1 7 7 7 1 8 8 1 7 7 7 7 7 7 7 7 1 8
8 8 8 8 8 8 1 7 1 7 1 7 7 7 7 7 1 7 1 7 1 7 7 7 1 7 1 8 8 1 7 7 7 7 7 7 7 7 1 8
8 8 8 8 8 8 1 7 1 7 1 1 1 1 1 7 1 1 1 7 1 1 1 1 1 7 1 8 8 1 7 7 7 7 7 7 7 7 1 8
8 8 8 8 8 8 1 7 7 7 7 7 7 7 1 7 1 7 1 7 1 7 7 7 1 7 1 8 8 1 7 7 7 7 7 7 7 7 1 8
8 8 8 8 8 8 1 7 1 1 1 1 1 7 1 1 1 7 1 7 1 1 1 7 1 7 1 8 8 1 1 1 1 7 7 1 1 1 1 8
8 8 8 8 8 8 1 7 1 7 7 7 1 7 7 7 1 7 7 7 1 7 1 7 1 7 1 8 8 8 8 8 1 7 7 1 8 8 8 8
8 8 8 8 8 8 1 7 1 7 1 7 1 7 1 1 1 7 1 7 1 7 1 7 1 7 1 1 1 1 1 1 1 7 7 1 8 8 8 8
8 8 8 8 8 8 1 7 7 7 1 7 1 7 7 7 7 7 1 7 7 7 7 7 1 7 7 7 7 7 7 7 7 7 7 1 8 8 8 8
8 8 8 8 8 8 1 1 1 1 1 1 1 1 1 1 1 1 1 1 1 1 1 1 1 1 1 1 1 1 1 1 1 1 1 1 8 8 8 8